WWWWWWWWWWWWWWW
WP    BBB BBBBW
W W W W W W W W
W RYR     B B W
WBW W W W WBW W
W       R  B  W
W W W W W W W W
WB   B   B YR W
WBW W W WBW W W
W RYRYBB   B BW
W WBW W W W W W
W YYRR   B R GW
WWWWWWWWWWWWWWW